1111111111111
10010000C0011
1110011111001
1P101100E0001
1111111111111