1111111111111
10010000C0011
1000011111001
1P001100E0001
1111111111111