11111111
10000001
11C00E01
1110C001