11111111
10000111
11C00E011
1110C011
11010001
11111111