11111111111111111111111111
11000000C000000C0011000011
11100010010001000000000001
10001000000000000000000011
110C001111100CCCCCCC000011
101CCC000000P0000000000011
10000000000111100010000011
10011000100000000000000011
100000E01000010000C1001011
11111111111111111111111111
