111111111111111111111111111111111111
1100000CCC01000000010000000100000001
10Y00000010000100000P000CCCCCC000R01
101011100000011100000000001000000101
1000000CCC000010000C00000001000CCC01
1000E0CCCC000000C00C0101010100000001
110000000000Y0B000RC0000000100000011
1001110000111000CCC00000000000000001
100000000000001000000000001110000001
100K0000000001110001100000000000B001
100100111000010000C00111111100001001
110000000000CCCCCCCCCCC0001000000011
111111111111111111111111111111111111