1111111111111
10010000C1011
1000011111001
1P00110000001
1111111111111