1111110111111
100100C001011
0P00011111001
100011000E001
1111111111111