11111111111111
10010000000C
1000011111001
1P0011E000001
1000011111001
1000011111001
1000011111001
1000011111001
10000111110014
1000011111001
1000011111001
1000011111001
