111111111111111111111111111111111111
1Y00000CCC000000000100000000000000R1
10000000000000000000P00000000CCCCC01
100000000000000000000000000000000001
1000000CCC000000000C00000001000CCC01
1000E0CCCC000000C00C0101010100000001
1100000000000000000C0000000100000001
100000000011100000000000000000000001
100000000000000000000000001110000011
100000000000000000011000000000000001
1000000111000000000C0000000000000001
1K00000000000000000000000010000000B1
111111111111111111111111111111111111