111111111111
1C0000000011
100100000P01
1000E0001011
111111111111
