11111111111111111111111111
100C000000CCCCC00011000011
111000100100010000CCCC0P01
100C10000000000000000C0011
1100C0111110000000000C0011
1010C000000000CCCCCC000011
1000C000000111100010000011
100110000000000000CCCC0011
100000E0000001000001001011
11111111111111111111111111
