111111111111111
10000000000P111
100000000C00001
10E000000000011
111111111111111