11111111111111111111
1C0C0C00P1C0C0C0C011
1C11011C0C0111C01001
1000110C011100000111
1C01110C1110C1100011
10C0C1E0000100101C11
11111111111111111111
