11111111111111111111111111
110C000000CCCCC00011000011
11100010010001R000CCCC0001
100C10000000000000000C0011
1100C0111110000000000C0011
1010C00B0000P0CCCCCC0K0011
1000C000000111100010000011
100110000000000000CCCC0011
100000E0000001Y00001001011
11111111111111111111111111
