11111111111111111111
100C0000P10000000011
10110110000111C01001
10001100011100000111
100111001110C1100011
10C001E0000100101C11
11111111111111111111
