11111111111111111111
100C0000000000000011
10000010000001000P01
10000000000000000011
10000000000000000011
10000000000000000011
10000000000000000011
10000000000000000011
100000E0000000001011
11111111111111111111
