11111111111111111111111111
11000000C000000C00110Y0011
111000100100010B0000000001
1K001000000000000000000011
110C001111100CCCCCCC000011
101CCC000000P0000000000011
10000000000111100010000R11
10011000100000000000000011
100000E01000010000C1R01011
11111111111111111111111111
