111111111
100C00P11
101010001
10E001011
111111111